NO utils/K1.xpm
SO utils/K4.xpm
WE utils/K3.xpm
EA utils/K2.xpm
F 161,117,42
C 0,160,253



111111111111111111111111111111111111111111111111111111111111111111111111111111111111111111111111111111111111111111111111111111111111111111111111111111111
10E0000000000000000000000000000000000000000000000000000000000000000000000000000000000000000000000000000000000000000000000000000000000000000000000000000001
100000000000000000000000000000011111111111111111111111111111111111111111111111111111111111111111111111111111111111111111111111111111111111111111111111100111111111111111111111111111111
1011111111111111111111111111111                                                                                                                        10000000000000000000000000000001
101                                                                                                                                                    10000000000000000000000000000001
101                                                                                                                                                    10000000000000000000000000000001
101                                                                                                                                                    10000000000000000000000000000001
101                                                                                                                                                    10000000000000000000000000000001
101                                                                                                                                                    10000000000000000000000000000001
101                                                                                                                                                    10000000000000000000000000000001
101                                                                                                                                                    10000000000000000000000000000001
101                                                                                                                                                    10000000000000000000000000000001
101                                                                                                                                                    10000000000000000000000000000001
101                                                                                                                                                    10000000000000000000000000000001
101                                                                                                                                                    10000000000000000000000000000001
101                                                                                                                                                    10000000000000000000000000000001
101                                                                                                                                                    10000000000000000000000000000001
101                                                                                                                                                    10000000000000000000000000000001
101                                                                                                                                                    10000000000000000000000000000001
101                                                                                                                                                    10000000000000000000000000000001
101                                                                                                                                                    10000000000000000000000000000001
101                                                                                                                                                    10000000000000000000000000000001
101                                                                                                                                                    10000011111111111111111111100001
101                                                                                                                                                    11111110000000000000000000111111        
101                                                                                                                                                    10000111111111111111111110100001
101                                                                                                                                                    10100000000000000000000000001001
101                                                                                                                                                    10100000000000000000000000001001
101                                                                                                                                                    10100000000000000000000000001001
101                                                                                                                                                    10100000000000000000000000001001
101                                                                                                                                                    10100000000000000000000000001001
101                                                                                                                                                    10100000000000000000000000001001
101                                                                                                                                                    10100000000000000000000000001001
101                                                                                                                                                    10100000000000000000000000001001
101                                                                                                                                                    10100000000000000000000000001001
101                                                                                                                                                    10100000000000000000000000001001
101                                                                                                                                                    10100000000000000000000000001001
1011111111111111111111111111111                                                                                                                        10100000000000000000000000001001
10000000000000000000000000000001                                                                                                                       11111111111111111111111111111111
10000000000000000000000000000001
10000000000000000000000000000001
10000000000000000000000000000001
10000000000000000000000000000001
10000000000000000000000000000001
10000000000000000000000000000001
10000000000000000000000000000001
10000000000000000000000000000001
10000000000000000000000000000001
10000000000000000000000000000001
10000000000000000000000000000001
10000000000000000000000000000001
10000000000000000000000000000001
10000000000000000000000000000001
10000000000000000000000000000001
10000000000000000000000000000001
10000011111111111111111111100001
10000110000000000000000000111111        
10000111111111111111111110100001
10100000000000000000000000001001
10100000000000000000000000001001
10100000000000000000000000001001
10100000000000000000000000001001
10100000000000000000000000001001
10100000000000000000000000001001
10100000000000000000000000001001
10100000000000000000000000001001
10100000000000000000000000001001
10100000000000000000000000001001
10100000000000000000000000001001
10100000000000000000000000001001
10100000000000000000000000001001
10100000000000000000000000001001
10100000000000000000000000001001
10000000000000000000000000000001
10111111111111111111111111111111
101
101
101
101
101
101
10111111111111111111111111111111
10000000000000000000000000000001
10000000000000000000000000000001
10000000000000000000000000000001
10000000000000000000000000000001
10000000000000000000000000000001
10000000000000000000000000000001
10000000000000000000000000000001
10000000000000000000000000000001
10000000000000000000000000000001
10000000000000000000000000000001
10000000000000000000000000000001
10000000000000000000000000000001
10000000000000000000000000000001
10000000000000000000000000000001
10000000000000000000000000000001
10000000000000000000000000000001
10000000000000000000000000000001
10000000000000000000000000000001
10000000000000000000000000000001
10000000000000000000000000000001
10000011111111111111111111100001
10000110000000000000000000111111        
10000111111111111111111110100001
10100000000000000000000000001001
10100000000000000000000000001001
10100000000000000000000000001001
10100000000000000000000000001001
10100000000000000000000000001001
10100000000000000000000000001001
10100000000000000000000000001001
10100000000000000000000000001001
10100000000000000000000000001001
10100000000000000000000000001001
10100000000000000000000000001001
10100000000000000000000000001001
10100000000000000000000000001001
10100000000000000000000000001001
101000000000000000000000000010011111111111111111111111111111111111111111111111111111111111111111111111111111111111111111111111
1000000000000000000000000000000000000000000000000000000000000000000000000000000000000000000000000000000000000000000000000000001
111111111111111111111111111111111111111111111111111111111111111111111111111111111111111111111111111111111111111111111111111100011111111111111111111111111111
                                                                                                                            10000000000000000000000000000001
                                                                                                                            10000000000000000000000000000001
                                                                                                                            10000000000000000000000000000001
                                                                                                                            10000000000000000000000000000001
                                                                                                                            10000000000000000000000000000001
                                                                                                                            10000000000000000000000000000001
                                                                                                                            10000000000000000000000000000001
                                                                                                                            10000000000000000000000000000001
                                                                                                                            10000000000000000000000000000001
                                                                                                                            10000000000000000000000000000001
                                                                                                                            10000000000000000000000000000001
                                                                                                                            10000000000000000000000000000001
                                                                                                                            10000000000000000000000000000001
                                                                                                                            10000000000000000000000000000001
                                                                                                                            10000000000000000000000000000001
                                                                                                                            10000000000000000000000000000001
                                                                                                                            10000000000000000000000000000001
                                                                                                                            10000000000000000000000000000001
                                                                                                                            10000000000000000000000000000001
                                                                                                                            10000000000000000000000000000001
                                                                                                                            10000011111111111111111111100001
                                                                                                                            10000110000000000000000000111111        
                                                                                                                            10000111111111111111111110100001
                                                                                                                            10100000000000000000000000001001
                                                                                                                            10100000000000000000000000001001
                                                                                                                            10100000000000000000000000001001
                                                                                                                            10100000000000000000000000001001
                                                                                                                            10100000000000000000000000001001
                                                                                                                            10100000000000000000000000001001
                                                                                                                            10100000000000000000000000001001
                                                                                                                            10100000000000000000000000001001
                                                                                                                            10100000000000000000000000001001
                                                                                                                            10100000000000000000000000001001
                                                                                                                            10100000000000000000000000001001
                                                                                                                            10100000000000000000000000001001
                                                                                                                            10100000000000000000000000001001
                                                                                                                            10100000000000000000000000001001
                                                                                                                            10100000000000000000000000001001
                                                                                                                            10100000000000000000000000001001
                                                                                                                            10100000000000000000000000001001
                                                                                                                            10100000000000000000000000001001
                                                                                                                            10100000000000000000000000001001
                                                                                                                            10000000000000000000000000000001
 1111111111111111111111111111111111111111111111111111111111111111111111111111111111111111111111111111111111111111111111111111111111111111111111111111111111111111                                                                                                                                                                                                                                                       11111111111111111111111111111111