NO utils/osaama.xpm
SO utils/m1.xpm
WE utils/m3.xpm
EA utils/m4.xpm
F 225,30,0
C 225,30,0111



1111111111
1010000001
1010100001
1011000001
10010N0001
1001001001
1001000101
1001000001
1001000001
1001000001
1001000001
1001000001
1001000001
1001000001
1001000001
1001000001
1001000001
1001000001
1001000001
1111111111
