
NO utils/wall.xmp

SO utils/wall.xpm





WE utils/wall.xpm







EA utils/wall.xpm







C 2,255,255






F 0           ,          255           ,                25









                    111111111111111111111111
10000000000001
11111111111110000000000001
1011000001110000000000001
10010000000000000000000011111111
111111111011000001110000000000001
100000000011000001110111111111111
11110111111111011100000010001
11110111111111011101010010001
11000000110101011100000010001
10000000000000001100000010001
10000000000000001101010010001








11000001110101011111011110N0111111