NO      utils/wall.xpm
SO utils/wall.xpm
WE utils/wall.xpm
EA utils/wall.xpm
C 2,255,255
F 0           ,          255           ,                25

        1111111111111
        1000000000110000000000001
        1011000001110000000000001
        1001000000000000000000001
111111 11000001110000000000001
101000100011000001110111111111111
111101111111110111000000100 1
1111011111111111111010010001
1100000011011      1111000000100011
10000000000001111110000010001
10000000000000001101010010001
11000001110101011111011110N0111
11110111 1110101 101111010001
11111111 1111111 111111111111
