NO utils/osaama.xpm
SO utils/m1.xpm
WE utils/m3.xpm
EA utils/m4.xpm
F 30,20,0111
C 30,50,0111



11111111111111111111111111111111
10000000000000000000000000000001
10111111111111111111111111111001
10100000000000000000000000001001
10101111111111111111111111101001
10101000000000000000000000001001
10101010111110111110111110101001
10101010100010000010000010101001
10101010101010101010101010101001
10101010101010101010101010101001
10101010101010101010101010101001
10101010100010000010000010101001
10101010111110111110111110101001
10101000000000000000000000001001
10101111111111111111111111101001
1010000000N000000000000000001001
10111111110111111111111111111001
10000000000000000000000000000001
11111111111111111111111111111111