NO utils/K1.xpm
SO utils/K2.xpm
WE utils/K3.xpm
EA utils/K4.xpm
F 161,117,42
C 0,160,253



11111111111111111111111111111111
10000000000000000000000000000001
10000000000000000000000000000001
10000000000000000000000000000001
10000000000000000000000000000001
10000000000000000000000000000001
10000000000000000000000000000001
10000000000000000000000000000001
10000000000000000000000000000001
10000000000000000000000000000001
10000000000000000000000000000001
10000000000000000000000000000001
10000000000000000000000000000001
10000000000000000000000000000001
10000000000000000000000000000001
10000000000000000000000000000001
10000000000000000000000000000001
10000000000000000000000000000001
10000000000000000000000000000001
10000000000000000000000000000001
10000000000000000000000000000001
10000011111111111111111111100001
10000111111111111111111111100001
10100000000000000000000000001001
10100000000000000000000000001001
10100000000000000000000000001001
10100000000000000000000000001001
10100000000000000000000000001001
10100000000000000000000000001001
10100000000000000000000000001001
10100000000000000000000000001001
10100000000000000000000000001001
10100000000000000000000000001001
10100000000000000000000000001001
10100000000000000000000000001001
10100000000000000000000000001001
10100000000000000000000000001001
10100000000000000000000000001001
1000000000000000N000000000000001
11111111111111111111111111111111