NO utils/wall.xpm
SO utils/wall.xpm
WE utils/wall.xpm
EA utils/wall.xpm
F 220,100,0
C 225,30,0

          111111111111111
   1     110000000001100
        10110000011100000000000011
        1001000000000000000000001
111111111011000001110000000000001
100000000011111111110111111111111
111101111111     1101100000010001
111101111111111111010100100011111
1100000011001011100000010001
10000000000000001100000010001
1000000000000000110101N010001
110000011101010101110111100111
11110111 1110101 101111010001
11111111 1111111 111111111111


