NO utils/wall.xpm
SO utils/wall.xpm
WE utils/floor.xpm
EA utils/floor.xpm
F 220,100,0
C 225,30,0


1111111111
1010000001
1010100001
1011000001
10010N0001
1001000001
1001000001
1001000001
1001000001
1001000001
1001000001
1001000001
1001000001
1001000001
1001000001
1001000001
1001000001
1001000001
1001000001
1111111111
