NO      utils/wall.xpm
SO utils/wall.xpm
WE utils/wall.xpm
EA utils/wall.xpm
C 2,255,255
F 0           ,          255           ,                25

        1111111111111
        1000000000110000000000001
        1011000001110000000000001
        1001000000000000000000001
 1 11111011000001110000000000001
101000000011000001110111111111111
11110111111111011100000010001
1111011111111101101010010001
11000000110101011100000010001
10000000000000001100000010001
10000000000000001101010010001
11000001110101011111011110N0111
11110111 1110101 101111010001
11111111 1111111 111111111111
